.#.####..#.#...#...##..#.#.##.
..#####.##..#..##....#..#...#.
......#.......##.##.#....##..#
..#..##..#.###.....#.#..###.#.
..#..#..##..#.#.##..###.......
...##....#.##.#.#..##.##.#...#
.##...#.#.##..#.#........#.#..
.##...##.##..#.#.##.#.#.#.##.#
#..##....#...###.#..##.#...##.
.###.###..##......#..#...###.#
.#..#.####.#..#....#.##..#.#.#
..#...#..#.#######....###.....
####..#.#.#...##...##....#..##
##..#.##.#.#..##.###.#.##.##..
..#.........#.#.#.#.......#..#
...##.#.....#.#.##........#..#
##..###.....#.............#.##
.#...#....#..####.#.#......##.
..#..##..###...#.....#...##..#
...####..#.#.##..#....#.#.....
####.#####.#.#....#.#....##.#.
#.#..#......#.........##..#.#.
#....##.....#........#..##.##.
.###.##...##..#.##.#.#...#.#.#
##.###....##....#.#.....#.###.
..#...#......#........####..#.
#....#.###.##.#...#.#.#.#.....
.........##....#...#.....#..##
###....#.........#..#..#.#.#..
##...#...###.#..#.###....#.##.